25 25 25 25 25 25 25 25 25 25 25 25 25 25 25 25 25 25 25 25 25 25 25 25 25 25 25 25 25 25 25 25 25 25 25 25 25 25 25 25 25 25 25 25 25 25 25 25 25 25
25 25 25 25 25 25 25 25 25 25 25 25 25 25 25 25 25 25 25 25 25 25 25 25 25 25 25 25 25 25 25 25 25 25 25 25 25 25 25 25 25 25 25 25 25 25 25 25 25 25
25 25 25 25 25 25 25 25 25 25 25 25 25 25 25 25 25 25 25 25 25 25 25 25 25 25 25 25 25 25 25 25 25 25 25 25 25 25 25 25 25 25 25 25 25 25 25 25 25 25
25 25 25 25 25 25 25 25 25 25 25 25 25 25 25 25 25 25 25 25 25 25 25 25 25 25 25 25 25 25 25 25 25 25 25 25 25 25 25 25 25 25 25 25 25 25 25 25 25 25
21 21 21 21 21 21 21 21 21 21 21 21 21 21 21 21 21 21 21 21 21 21 19 21 21 21 21 21 21 21 21 21 21 21 21 21 21 21 21 21 21 21 21 25 25 25 25 25 25 22
26 26 26 26 26 26 26 21 26 26 26 26 26 26 26 26 26 26 26 26 26 21 26 21 26 26 26 26 26 26 26 26 26 26 26 26 26 26 26 26 26 26 21 25 25 25 25 25 25 22
21 21 21 21 26 26 26 21 26 26 26 26 26 26 26 26 26 26 26 26 26 21 26 21 26 21 26 21 21 21 26 26 26 26 26 26 26 26 26 26 26 26 19 25 25 25 25 25 25 22
26 26 26 21 21 21 26 21 26 26 26 26 26 26 26 26 26 26 26 26 26 21 26 21 26 21 26 21 26 21 21 21 21 26 26 26 26 21 21 21 21 21 21 25 25 25 25 25 25 22
26 26 26 26 26 21 21 21 21 21 21 21 21 21 21 21 21 26 21 21 21 21 26 21 21 21 26 21 26 26 26 26 21 26 21 21 21 21 26 26 26 26 21 25 25 25 25 25 25 22
26 26 26 26 26 26 26 19 26 26 26 26 26 26 26 26 26 26 26 26 26 26 26 26 26 26 26 26 26 26 26 26 21 21 21 26 26 26 26 26 26 26 21 25 25 25 25 25 25 22
21 21 21 21 21 21 21 21 26 26 26 26 26 26 26 26 26 26 26 26 26 26 26 26 26 26 26 26 26 26 26 26 26 26 26 26 26 21 21 21 26 26 21 25 25 25 25 25 25 22
26 26 26 26 26 26 26 21 26 21 21 21 21 21 21 21 21 21 21 21 21 21 26 21 21 21 21 21 21 21 21 26 21 21 21 21 21 21 26 21 26 26 21 25 25 25 25 25 25 22
26 26 26 26 26 26 26 21 26 21 26 26 26 26 26 26 26 26 26 26 26 21 26 21 26 26 26 26 26 26 21 26 21 26 26 26 26 26 26 21 26 26 21 25 25 25 25 25 25 22
26 26 26 26 26 26 26 21 26 21 26 26 26 26 26 26 26 26 26 26 26 26 26 26 26 26 26 26 26 26 21 26 26 26 26 26 26 26 26 26 26 26 21 25 25 25 25 25 25 22
21 21 21 21 21 21 21 21 19 21 21 21 21 21 21 21 21 21 21 21 21 21 21 21 21 21 21 21 21 21 21 19 21 21 21 21 21 21 21 21 21 21 21 25 25 25 25 25 25 22
25 25 25 25 25 25 25 25 25 25 25 25 25 25 25 25 25 25 25 25 25 25 25 25 25 25 25 25 25 25 25 25 25 25 25 25 25 25 25 25 25 25 25 25 25 25 25 25 25 25
25 25 25 25 25 25 25 25 25 25 25 25 25 25 25 25 25 25 25 25 25 25 25 25 25 25 25 25 25 25 25 25 25 25 25 25 25 25 25 25 25 25 25 25 25 25 25 25 25 25
25 25 25 25 25 25 25 25 25 25 25 25 25 25 25 25 25 25 25 25 25 25 25 25 25 25 25 25 25 25 25 25 25 25 25 25 25 25 25 25 25 25 25 25 25 25 25 25 25 25
25 25 25 25 25 25 25 25 25 25 25 25 25 25 25 25 25 25 25 25 25 25 25 25 25 25 25 25 25 25 25 25 25 25 25 25 25 25 25 25 25 25 25 25 25 25 25 25 25 25
21 21 21 21 21 21 21 21 21 21 21 21 21 21 21 21 21 21 21 21 21 21 21 21 21 21 21 21 21 21 25 25 25 25 25 25 25 21 21 21 21 21 21 21 21 25 25 25 25 25
21 21 21 21 21 21 21 21 21 21 21 21 21 21 21 21 21 21 21 21 21 21 21 21 21 21 21 21 21 21 25 25 25 25 25 25 25 21 26 26 26 26 26 26 21 25 25 25 25 25
21 21 21 21 21 21 21 21 21 21 21 21 21 21 21 21 21 21 21 21 21 21 21 21 21 21 21 21 21 21 25 25 25 25 25 25 25 21 26 26 26 26 26 26 21 25 25 25 25 25
21 21 21 21 21 21 21 21 21 21 21 21 21 21 21 21 21 21 21 21 21 21 21 21 21 21 21 21 21 21 25 25 25 25 25 25 25 21 26 26 26 26 26 26 21 25 25 25 25 25
21 21 21 21 21 21 21 21 21 21 21 21 21 21 21 21 21 21 21 21 21 21 21 21 21 21 21 21 21 21 25 25 25 25 25 25 25 21 26 26 21 21 26 26 21 25 25 25 25 25
21 21 21 21 21 21 21 21 21 21 21 21 21 21 21 21 21 21 21 21 21 21 21 21 21 21 21 21 21 21 25 25 25 25 25 25 25 21 26 26 26 26 26 26 21 25 25 25 25 25
21 21 21 21 21 21 21 21 21 21 21 21 21 21 21 21 21 19 21 21 21 21 21 21 21 21 21 21 21 21 25 25 25 25 25 25 25 21 26 26 26 26 26 26 21 25 25 25 25 25
22 22 22 22 22 22 22 20 22 22 22 22 22 22 22 22 22 22 22 22 22 22 20 22 22 22 22 22 22 22 25 25 25 25 25 25 25 21 26 26 26 26 26 26 21 25 25 25 25 25
22 22 22 22 22 22 22 20 22 22 22 22 22 22 22 22 22 22 22 22 18 22 20 22 22 22 18 22 18 22 25 25 25 25 25 25 25 21 26 26 26 26 26 26 21 25 25 25 25 25
22 22 22 18 22 22 22 20 22 22 22 22 22 22 22 22 22 22 22 22 22 22 20 22 22 22 22 22 22 22 25 25 25 25 25 25 25 21 26 26 26 26 26 26 21 25 25 25 25 25
22 22 22 22 22 22 22 20 22 22 18 22 22 22 22 22 22 22 22 22 22 22 20 22 18 22 22 22 22 22 25 25 25 25 25 25 25 21 26 26 26 26 26 26 21 25 25 25 25 25
22 22 22 22 22 18 22 20 22 22 22 22 22 22 22 22 22 22 22 22 22 22 20 22 22 22 22 22 22 22 25 25 25 25 25 25 25 21 26 26 26 26 26 26 21 25 25 25 25 25
22 22 22 22 22 22 22 20 22 22 22 22 22 22 22 22 22 22 22 22 22 22 20 22 22 22 18 22 22 22 25 25 25 25 25 25 25 21 26 26 26 26 26 26 21 25 25 25 25 25
22 18 22 22 22 22 22 20 22 22 22 22 22 22 22 22 22 22 18 22 22 22 20 22 18 22 22 22 22 22 25 25 25 25 25 25 25 21 26 26 26 26 26 26 21 25 25 25 25 25
22 22 22 22 22 22 22 20 22 22 22 22 22 22 22 22 22 22 22 22 22 22 20 22 22 22 22 22 22 22 25 25 25 25 25 25 25 21 26 26 26 26 26 26 21 25 25 25 25 25
22 22 22 22 22 22 22 20 22 22 22 18 22 22 22 22 22 22 22 22 22 22 20 22 18 22 22 22 22 22 25 25 25 25 25 25 25 21 26 26 26 26 26 26 21 25 25 25 25 25
22 22 22 18 22 22 22 20 22 22 22 22 22 22 22 22 22 22 22 22 22 22 20 22 22 22 18 22 22 22 25 25 25 25 25 25 25 21 26 26 26 26 26 26 21 25 25 25 25 25
18 22 22 22 22 22 22 20 22 22 18 22 22 22 22 22 18 22 22 22 18 22 20 18 22 22 22 18 22 22 25 25 25 25 25 25 25 21 26 26 26 26 26 26 21 25 25 25 25 25
22 22 22 22 22 22 22 20 22 22 22 22 22 22 22 22 22 22 22 22 22 22 20 22 22 22 22 22 22 22 25 25 25 25 25 25 25 21 26 26 26 26 26 26 21 25 25 25 25 25
22 22 22 22 22 18 22 20 22 22 22 22 22 22 22 22 22 22 22 22 22 22 20 18 22 22 22 22 22 22 25 25 25 25 25 25 25 21 26 26 26 26 26 26 21 25 25 25 25 25
22 22 22 22 22 22 22 20 22 22 22 22 22 22 22 22 22 22 18 22 22 22 20 22 22 18 22 22 22 22 25 25 25 25 25 25 25 21 26 26 26 26 26 26 21 25 25 25 25 25
22 22 22 22 22 22 22 20 22 22 18 22 22 22 22 22 22 22 22 22 22 22 20 22 22 22 22 22 22 22 25 25 25 25 25 25 25 21 26 26 26 26 26 26 21 25 25 25 25 25
22 22 18 22 22 22 22 20 22 22 22 22 22 22 22 22 22 22 22 22 22 22 20 22 22 18 22 22 22 22 25 25 25 25 25 25 25 21 26 26 26 26 26 26 21 25 25 25 25 25
22 22 22 22 22 22 22 20 22 22 22 22 22 22 22 22 22 22 18 22 22 22 20 22 22 22 22 18 22 22 25 25 25 25 25 25 25 21 26 26 26 26 26 26 21 25 25 25 25 25
22 22 22 22 22 22 22 20 22 22 18 22 22 22 22 22 22 22 22 22 22 22 20 22 22 22 22 22 22 22 25 25 25 25 25 25 25 21 26 26 26 26 26 26 21 25 25 25 25 25
22 22 22 18 22 22 22 20 22 22 22 22 22 22 22 22 22 22 22 22 22 22 20 22 22 22 22 22 22 22 25 25 25 25 25 25 25 21 26 26 26 26 26 26 21 25 25 25 25 25
22 22 22 22 22 22 22 20 24 24 24 24 24 24 24 24 24 24 24 24 24 24 20 22 22 22 22 22 22 22 25 25 25 25 25 25 25 21 21 21 21 21 21 21 21 25 25 25 25 25
22 22 18 22 22 18 22 24 24 23 23 23 23 23 23 23 23 23 23 23 23 24 24 22 22 22 22 22 22 22 25 25 25 25 25 25 25 25 25 25 25 25 25 25 25 25 25 25 25 25
22 22 22 22 22 22 22 24 23 24 24 24 24 24 24 24 24 24 24 24 24 23 24 22 22 22 22 22 22 22 25 25 25 25 25 25 25 25 25 25 25 25 25 25 25 25 25 25 25 25
22 22 18 22 22 22 22 24 23 24 24 24 24 24 24 24 24 24 24 24 24 23 24 22 22 22 22 22 22 22 25 25 25 25 25 25 25 25 25 25 25 25 25 25 25 25 25 25 25 25
22 22 18 22 22 22 22 24 23 24 24 24 24 24 24 24 24 24 24 24 24 23 24 22 22 22 22 22 22 22 25 25 25 25 25 25 25 25 25 25 25 25 25 25 25 25 25 25 25 25