16 16 16 16 16 16 16 16 16 16 16 16 16 16 16 16 16 16 16 16 16 16 16 16 16 16 16 16 16 16 16 16 16 16 16 16 16 16 16 16 16 16 16 16 16 16 16 16 16 16
16 16 16 16 16 16 16 16 16 16 16 16 16 16 16 16 16 16 16 16 16 16 16 16 16 16 16 16 16 16 16 16 16 16 16 16 16 16 16 16 16 16 16 16 16 16 16 16 16 16
16 16 16 16 16 16 16 16 16 16 16 16 16 16 16 16 16 16 16 16 16 16 16 16 16 16 16 16 16 16 16 16 16 16 16 16 16 16 16 16 16 16 16 16 16 16 16 16 16 16
16 16 16 16 16 16 16 16 16 16 16 16 16 16 16 16 16 16 16 16 16 16 16 16 16 16 16 16 16 16 16 16 16 16 16 16 16 16 16 16 16 16 16 16 16 16 16 16 16 16
16 16 16 16 16 16 16 16 16 16 16 16 16 16 16 16 16 16 16 16 16 16 16 16 16 16 16 16 16 16 16 16 16 16 16 16 16 16 16 16 16 16 16 16 16 16 16 16 16 16
16 16 16 16 16 16 16 17 17 17 17 17 17 17 17 17 17 17 17 17 17 17 17 17 17 17 17 17 17 17 17 17 17 17 17 17 17 17 17 17 17 17 17 17 17 17 16 16 16 16
16 16 16 16 16 16 17 17 17 17 17 17 17 17 15 15 17 17 17 17 17 17 17 17 17 17 15 15 15 15 15 15 17 15 15 15 15 15 15 15 15 15 15 15 17 17 17 16 16 16
16 16 16 16 16 17 17 17 17 17 17 17 17 15 14 14 15 17 17 17 17 17 17 17 17 15 14 14 14 14 14 14 15 14 14 14 14 14 14 14 14 14 14 15 17 17 17 17 16 16
16 16 16 16 17 17 17 17 17 17 17 17 17 15 14 14 15 17 17 17 17 17 17 17 15 14 14 14 14 15 15 14 15 14 14 14 14 14 14 14 14 14 14 15 17 17 17 17 17 16
16 16 16 17 17 17 17 17 17 17 15 15 15 15 14 14 15 15 15 15 15 15 15 15 15 14 14 14 15 17 15 14 15 14 15 15 15 15 14 14 14 14 14 15 17 17 17 17 16 16
16 16 17 17 17 17 17 17 17 17 15 14 14 14 14 14 14 14 14 14 14 14 14 14 14 14 14 15 17 15 14 14 15 14 15 17 17 15 14 14 14 14 14 15 17 17 17 17 16 16
16 17 17 17 17 17 17 17 17 17 15 14 14 14 14 14 14 14 14 14 14 14 14 14 14 14 14 15 17 15 14 15 14 14 15 17 17 15 14 14 14 14 14 15 17 17 17 17 16 16
16 17 17 17 17 17 17 17 17 17 15 14 14 15 15 15 15 15 15 15 15 15 14 14 14 14 14 15 17 15 14 15 14 14 15 17 17 15 14 14 14 14 14 15 17 17 17 17 16 16
16 17 17 17 17 17 17 17 15 15 15 14 14 15 17 17 15 14 14 15 17 15 14 14 14 14 14 15 17 15 14 14 14 14 15 17 17 15 14 14 14 14 14 15 17 17 17 17 17 16
16 17 17 17 17 17 17 15 14 14 14 14 14 15 17 17 15 14 14 15 17 15 15 15 15 15 15 15 17 15 15 15 15 15 15 17 17 15 15 15 15 15 15 15 17 17 17 17 16 16
16 17 17 17 17 17 17 15 14 14 15 14 14 15 17 17 15 14 14 15 17 17 17 17 17 17 17 15 17 17 15 17 17 17 17 17 17 17 17 17 17 15 17 17 17 17 17 17 17 16
16 17 17 17 17 17 17 17 15 15 15 14 14 15 17 17 15 14 14 15 17 17 17 17 17 17 17 15 17 17 15 17 17 17 17 17 17 17 17 17 17 15 17 17 17 17 17 17 16 16
16 17 17 17 17 17 17 17 15 17 15 14 14 15 17 17 15 14 14 15 17 17 17 17 17 17 17 15 17 17 15 17 17 17 17 17 17 17 17 17 17 15 17 17 17 17 17 17 16 16
16 16 16 17 17 17 17 17 15 17 15 14 14 15 17 17 15 14 14 15 17 17 17 17 17 17 17 15 17 17 15 15 15 17 17 15 15 15 15 15 15 15 17 17 17 17 17 17 16 16
16 16 16 16 17 17 17 17 15 17 15 14 14 15 15 15 15 14 14 15 15 15 15 15 15 15 15 15 15 15 15 14 14 15 15 14 14 14 14 14 14 15 17 17 17 17 17 17 16 16
16 16 16 17 17 17 17 17 15 17 15 14 14 14 14 14 14 14 14 14 14 14 14 14 14 14 15 17 17 17 15 14 14 14 14 14 14 15 14 14 14 15 17 17 17 17 17 17 16 16
16 17 17 17 17 17 17 17 15 17 15 14 14 14 14 14 14 14 14 14 14 14 14 14 14 14 15 15 17 17 15 14 14 15 15 14 14 15 15 14 14 15 17 17 17 17 17 17 16 16
16 17 17 17 17 17 17 17 15 17 15 14 14 15 15 15 15 15 15 15 15 15 15 15 14 14 14 15 17 17 15 15 15 17 17 15 15 17 15 14 14 15 17 17 17 17 17 17 16 16
16 17 17 17 17 17 17 17 15 17 15 14 14 15 17 17 17 15 17 17 17 17 17 15 14 14 14 15 15 15 17 17 17 17 17 17 17 17 15 14 14 15 17 17 17 17 17 17 16 16
16 17 17 17 17 17 17 17 15 15 15 14 14 15 17 17 17 15 17 17 17 17 17 15 15 14 14 14 14 15 17 17 17 17 17 17 17 17 15 14 14 15 17 17 17 17 17 17 16 16
16 17 17 17 17 17 17 15 14 15 15 14 14 15 17 17 17 15 17 17 17 17 17 15 15 14 14 14 14 15 15 15 17 17 17 17 17 17 15 14 14 15 17 17 17 17 17 17 17 16
16 17 17 17 17 17 17 15 14 15 15 14 14 15 17 17 17 15 17 17 17 17 17 15 17 15 15 14 14 14 14 14 15 17 17 17 17 17 15 14 14 15 17 17 17 17 17 17 16 16
16 17 17 17 17 17 17 15 14 15 15 14 14 15 17 17 17 15 17 17 17 17 17 15 17 17 15 14 14 14 14 14 15 17 17 17 17 17 15 14 14 15 17 17 17 17 17 17 16 16
16 17 17 17 17 17 17 15 14 15 15 14 14 15 17 17 17 15 17 17 17 17 17 15 17 17 17 15 14 14 14 14 15 17 17 17 17 17 15 14 14 15 17 17 17 17 17 17 16 16
16 16 16 17 17 17 17 15 14 15 15 14 14 15 15 15 15 15 15 15 15 15 15 15 17 17 17 17 15 15 14 14 15 15 15 15 15 15 15 14 14 15 17 17 17 17 17 17 16 16
16 16 16 16 17 17 17 15 14 15 15 14 14 15 17 17 17 15 14 14 14 14 14 14 15 15 15 15 14 14 14 14 14 14 14 14 14 14 14 14 14 15 17 17 17 17 17 17 16 16
16 16 16 17 17 17 17 15 14 14 15 14 14 15 17 17 17 15 14 14 14 14 14 14 15 17 17 15 14 14 14 14 14 14 14 14 14 14 14 14 14 15 17 17 17 17 17 17 16 16
16 17 17 17 17 17 17 15 14 14 14 14 14 15 17 17 17 15 14 14 14 14 14 14 15 17 17 15 14 14 14 15 15 15 15 15 15 15 14 14 14 15 17 17 17 17 17 17 16 16
16 17 17 17 17 17 17 15 14 15 15 14 14 15 17 17 17 15 14 14 14 14 14 14 15 15 15 15 14 14 15 17 17 17 17 17 17 17 15 14 14 15 15 17 17 17 17 17 16 16
16 17 17 17 17 17 17 15 14 15 15 14 14 15 15 15 15 15 14 14 14 14 14 14 14 14 14 14 14 14 15 17 17 17 17 17 17 17 15 14 14 14 15 17 17 17 17 17 17 16
16 17 17 17 17 17 17 15 14 15 15 14 14 14 14 14 14 14 14 14 14 14 14 14 14 14 14 14 14 14 15 17 17 17 17 17 17 17 15 14 14 14 15 17 17 17 17 17 16 16
16 17 17 17 17 17 17 15 14 15 15 14 14 14 14 14 14 14 14 14 14 14 14 14 15 15 15 14 14 15 15 17 17 17 17 17 17 17 15 14 14 14 15 17 17 17 17 17 16 16
16 17 17 17 17 17 17 15 14 15 15 15 15 14 14 14 14 14 14 14 14 14 14 14 15 17 15 14 14 15 17 17 17 17 17 17 17 17 15 14 14 14 15 17 17 17 17 17 16 16
16 17 17 17 17 17 17 15 14 15 17 17 15 14 15 15 15 15 14 14 14 14 14 14 15 17 15 14 14 15 17 17 17 17 17 17 17 17 17 15 14 15 17 17 17 17 17 17 16 16
16 17 17 17 17 17 17 17 15 15 17 17 15 14 15 17 17 15 14 14 14 14 14 14 15 15 15 14 14 15 17 17 17 17 17 17 17 17 15 14 14 14 15 17 17 17 17 17 16 16
16 16 16 16 17 17 17 17 15 17 17 17 15 14 15 17 17 15 14 14 14 14 14 14 15 17 15 14 14 15 17 17 17 17 17 17 17 15 14 14 14 14 14 15 17 17 17 17 16 16
16 16 16 16 16 17 17 17 15 17 17 17 15 14 15 17 17 15 14 14 14 14 14 14 15 17 15 14 14 15 17 17 17 17 17 17 17 15 14 14 14 14 14 15 17 17 17 17 17 16
16 16 16 16 17 17 17 17 15 17 17 15 15 14 15 17 17 15 15 15 14 14 14 14 15 15 15 14 14 15 17 17 17 17 17 17 17 15 14 14 14 14 14 15 17 17 17 17 16 16
16 16 17 17 17 17 17 15 15 15 15 15 14 14 15 17 17 17 17 15 14 14 14 14 14 14 14 14 14 15 17 17 17 17 17 17 17 15 14 14 14 14 14 15 17 17 17 17 16 16
16 16 17 17 17 17 17 15 14 14 14 14 14 14 15 17 17 17 17 15 14 14 14 14 14 14 14 14 14 15 17 17 17 17 17 17 17 15 14 14 14 14 14 15 17 17 17 17 16 16
16 16 17 17 17 17 17 15 15 15 15 15 15 15 17 17 17 17 17 17 15 15 15 15 15 15 15 15 15 15 15 15 15 15 15 15 15 15 15 15 15 15 15 15 17 17 17 17 16 16
16 16 16 17 17 17 17 17 17 17 17 17 17 17 17 17 17 17 17 17 17 17 17 17 17 17 17 17 17 17 17 17 17 17 17 17 17 17 17 17 17 17 17 17 17 17 17 16 16 16
16 16 16 17 17 17 17 17 17 17 17 17 17 17 17 17 17 17 17 17 17 17 17 17 17 17 17 17 17 17 17 17 17 17 17 17 17 17 17 17 17 17 17 17 17 17 16 16 16 16
16 16 16 16 17 17 17 17 17 17 17 17 17 17 17 17 17 17 17 17 17 17 17 17 17 17 17 17 17 17 17 17 17 17 17 17 17 17 17 17 17 17 17 17 17 16 16 16 16 16
16 16 16 16 16 16 16 16 16 16 16 16 16 16 16 16 16 16 16 16 16 16 16 16 16 16 16 16 16 16 16 16 16 16 16 16 16 16 16 16 16 16 16 16 16 16 16 16 16 16